000000000000000000000000000000000000
000000000000000000000000000000000000
000000000000000000000000000000000000
000000000000000000000000000000000000
000000000000000000000000000000000000
000000000000000000000000000000000000
000000000000000000000000000000000000
000000000000000000000000000000000000
000000000000000000000000000000000000
000000000000000000000000000000000000
000555550000000000000000000000000000
000700080000000000000000000000000000
000700080000000000000000000000000000
000555555555555555555555555555555555
000700000000000000000000000000000008
000700000000000000000000000000000008
000700000000000000000000000000000008
000700000000000000000000000000000008
000700000000000000000000000000000008
000700000000000000000000000000000008
000700000000000000000000000000000008
000700000000000000000000000000000008
000700000000000000000000000000000008
000700000000000000000001110000000008
000700000000000000000000000000000008
000700000000000011110000000000000008
000700000000000000000000000000000008
000700000011100000000000000011000008
000700000000000000000000000000000028
000700000000001100000000000000000008
000700000000000000000000000000001118
000700000000000001100000000000000008
000700000001110000000000000000000008
000700000000000000000000000000000008
000666666666666666666666666666666666
