000000000000000000000000000000000000
000000000000000000000000000000000000
000000000000000000000000000000000000
000000000000000000000000000000000000
000000000000000000000000000000000000
000000000000000000000000000000000000
000000000000000000000000000000000000
000000000000000000000000000000000000
000000000000000000000000000000000000
000000000000000000000000000000000000
000555550000000000000000000000000000
000700080000000000000000000000000000
000700080000000000000000000000000000
000555555555555555555555555555555555
000700000000000000000000000000000008
000700000000000000000000000000000008
000700000000000000000000000000000008
000700000000000000000000000000000008
000700000000000000000000000000000008
000700000000000000000000000000000008
000700000000000000000000000000000008
000700000000002000000000000000000008
000700000000000000000000000000000008
000700000000001110000000000000000008
000700000000000000000111110000000008
000700000000000000000000000000100008
000700000000000000000000000000000008
000700000000000000000000000000000108
000700000000000000000000000000000008
000700000000000000000000001111100008
000700000000001111000000000000000008
000700000000000000000110000000000008
000700000111000000000000000000000008
000700000000000000000000000000000008
000666666666666666666666666666666666
