000000000000000000000000000000000000
000000000000000000000000000000000000
000000000000000000000000000000000000
000000000000000000000000000000000000
000000000000000000000000000000000000
000000000000000000000000000000000000
000000000000000000000000000000000000
000000000000000000000000000000000000
000000000000000000000000000000000000
000000000000000000000000000000000000
000555550000000000000000000000000000
000700080000000000000000000000000000
000700080000000000000000000000000000
000555555555555555555555555555555555
000700000000000000000000000000000008
000700000000000000000000000000000008
000700000000000000000000000000000008
000700000000000000000000000000000008
000700000000000000000000000000000008
000700000000000000000000000000000008
000700000000000000000002000000000008
000700000000000000000000000000000008
000700000000000000000001100000000008
000700000000000000000000000000000008
000700000000000000000000000110000008
000700000000000000000111000000000008
000700000000000000000000000000000008
000700000000000111000000000000000008
000700011100000000000000000000000008
000700000000000000000000000000000008
000700000000110000000000000000000008
000700000000000000000000000000000008
000700000111000000000000000000000008
000700000000000000000000000000000008
000666666666666666666666666666666666